PTTTTTTTTTTTTTXYTTTTTTTTTTTTTB
R             VR             R
R PTB  PTTTB  VR  PTTTB  PTB R
R V R  V   R  VR  V   R  V R R
R QAD  QAAAD  QD  QAAAD  QAD R
R                            R
R                            R
R PTB PB   PTTTTTTB   PB PTB R
R QAD VR   QAAXYAAD   VR QAD R
R     VR      VR      VR     R
QTTB  VQTTTB  VR  PTTTDR  PTTD
.  R  VPAAAD  QD  QAAABR  V  .
.  R  VR              VR  V  .
.  R  VR  4WWWTTWWW5  VR  V  .
AAAD  QD  8   G  C 9  QD  QAAA
.         8 E   1  9         .
.         8  23    9         .
TTTB  PB  6KKKKKKKK7  PB  PTTT
.  R  VR              VR  V  .
.  R  VR   PTTTTTTB   VR  V  .
.  R  QD   QAAXYAAD   QD  V  .
PAAD          VR          QAAB
R     PTTTTB  VR  PTTTTB     R
R     QAAAAD  QD  QAAAAD     R
R                            R
R   PTTB  PTTTTTTTTB  PTTB   R
R   QABR  V        R  RPAD   R
R     QD  QAAAAAAAAD  QD     R
R                            R
QTB   PB  PTTTTTTTTB  PB   PTD
PAD   VR  QAAABPAAAD  VR   QAB
R     VR      VR      VR     R
R PTTTDQTTTB  VR  PTTTDQTTTB R
R QAAAAAAAAD  QD  QAAAAAAAAD R
R                            R
QAAAAAAAAAAAAAAAAAAAAAAAAAAAAD
