PPPTTTTTTTTTTTTTTTTTTTTTTTTTTT
P							 P
P							 P
T                            T
T			                 T
T                            T
T                            T
T                            T
T                            T
T                            T
T                            T
.                            .
.                            .
.                            .
T              P             T
.                            .
.                            .
T                            T
.                            .
.                            .
.                            .
T                            T
T                            T
T                            T
T                            T
T                            T
T                            T
C                            C
CCC                          C
C                            C
T                            T
TTTTTTTTTTTTTTTTTTTTTTTTTTTTTT                       